# Unknown:
#
* ???????????????????????????????????
* ???????????????????????????????????
* ??????????????       ??????????????
* ????????????    ???    ????????????
* ??????????    ???????   ???????????
* ?????????????????????   ???????????
* ???????????????????   ?????????????
* ?????????????????   ???????????????
* ????????????????   ????????????????
* ???????????????   ?????????????????
* ???????????????   ?????????????????
* ???????????????   ?????????????????
* ???????????????   ?????????????????
* ???????????????????????????????????
* ???????????????? ??????????????????
* ???????????????   ?????????????????
* ???????????????? ??????????????????
* ???????????????????????????????????
* ???????????????????????????????????
